R 1024 720
NO ./textures/redbrick.xpm
SO ./textures/purplestone.xpm
WE ./textures/greystone.xpm
EA ./textures/mossy.xpm
S ./textures/barrel.xpm
F 127,127,127
C 25,120,230

11111 11111 111111111111111111111
10000100001110000000000000S000001
100000000000000000000000000000001
100000000111100000110020002000201
11111111111 100001110000200020001
            100000000000002000001
111111111111100001110000000000001
100000000011000001110111110111111
11110111111111011100000010001
11110111111111011101010010001 111
11000000110101001100000010101 101
10000000000000001100000010001 101
10000000000000001101010010001 111
11000001110101011111011010001
11110111 1110111 111111010001
11110111 111011111111110111111111
111101111111000001110000000000001
100000000000000001110111111111111
11110111111111011100000010001
11110111111111011101010010001 1
11000000110101011100000010001101
10000000000000000000000000001 1
10000000000000001101010010001
1100000010010101111101111000111
10110111 1110101 111111110001
11111111 1111111 111111111111