R 1080 720
NO ./textures/redbrick.xpm
SO ./textures/purplestone.xpm
WE ./textures/greystone.xpm
EA ./textures/mossy.xpm
S ./textures/barrel.xpm
F 127,127,127
C 25,120,230

111111111111111111111111111111111
100000001001000000000S00000000001
100000001001000000000000000000001
1000000000000000001100000020000011111
100000001011000001110000200020001
100000001001000000000000002000001
111111111011000001110000000000001
100000000011000001110111110111111
111111111111111111110111111111111