R 1080 720
NO ./textures/redbrick.xpm
SO ./textures/purplestone.xpm
WE ./textures/greystone.xpm
EA ./textures/mossy.xpm
S ./textures/barrel.xpm
F 127,127,127
C 25,120,230

        1111111111111111111111111
        1000000000110000000000001
        1011000001110000002000001
        100100000000000 0000 0001
111111111011000001110000000000001
100000000011000001110111111111111
11110111111 11011100000010001
1 11011111111101110101001000N
11000000110101011100000010001
10002000000 00001100000010001
100 0000000000001101010010001
1100000111010101111101111000111
11110111 1110101 101111010001
11111111 1111111 111111111111