R 1920 1080
NO ./textures/redbrick.xpm
SO ./textures/purplestone.xpm
WE ./textures/greystone.xpm
EA ./textures/mossy.xpm
S ./textures/pillar.xpm

F 255,255,0
C 225,30,0

        1111111111111111111111111
        1000000000110000000000001
        1011000001110000002000001
        1001000000000000000000001
111111111011000001110000000000001
100000000011000001110111111111111
11110111111111011100000010001    
11110111111111011101010010001    
11000000110101011100000010001    
10002000000000001100000010001    
10000000000000001101010010001    
11000001110101011111011010N0111  
11110111 1110111 111111010001    
11110111 111011111111110111111111
111101111111000001110000000000001
100000000000000001110111111111111
11110111111111011100000010001    
11110111111111011101010010001    
11000000110101011100000010001    
10002000000000001100000010001    
10000000000000001101010010001    
1100000111010101111101111000111  
11110111 1110101 111111110001    
11111111 1111111 111111111111    