R 1080 720
NO ./textures/redbrick.xpm
SO ./textures/purplestone.xpm
WE ./textures/greystone.xpm
EA ./textures/bluestone.xpm
S ./textures/barrel.xpm

F 127,127,127
C 25,120,230

111111111111111111111111111111111
100000001001000000000000000000001
100000001001000000000000000000001
100000000000000000110000002000001
10000000101100000111N000200020001
100000001001000000000000002000001
111111111011000001110000000000001
100000000011000001110111110111111
11110111111111011100000010001    
11110111111111011101010010001    
11000000110101011100000010101    
10000000000000001100000010001    
10000000000000001101010010001    
1100000111010101111101101000111  
11110111 1110111 111111010001    
11110111 111011111111110111111111
111101111111000001110000000000001
100000000000000001110111111111111
11110111111111011100000010001    
11110111111111011101010010001    
11000000110101011100000010001    
10000000000000000000000000001    
10000000000000001101010010001    
1100000111010101111101111000111  
11110111 1110101 111111110001    
11111111 1111111 111111111111    