R 800 800
NO textures/redbrick.xpm
SO textures/purplestone.xpm
WE textures/greystone.xpm
EA textures/mossy.xpm
S textures/barrel.xpm
F 150,150,150
C 254,254,254

1111111111111111111
1000000000000000001
1000000000000000001
1000111111111100001
1000000000000100001
1111111111000111111
1000000000000000001
1000000000000000001
1002000000000000W01
1000000000000000001
1111111111111111111